25 20
#############    ####e###
#...........#    #......#
#...s...s...#    #......#
#....k......#    #....s.#
#...........#    #......#
#.....s.....#    #...k..#
#......b....#    #......#
#...........#    #.s....#
#####..######    ###rd###
    #..#           #..#
    #..#           #..#
    #..#          ##..##
  ###..####      #......#
  #.......#      #......#
  #.s.....########.s....#
  #.......d.............#
  #.......########...k..#
  #..../..#      #......#
  #@......#      #...s..#
  #########       ######
